R 1366 768

NO ./textures/n_concrete1.xpm
SO ./textures/s_concrete1.xpm
WE ./textures/w_concrete1.xpm
EA ./textures/e_concrete1.xpm
S ./sprites/guard.xpm

F 50, 90, 60
C 100, 100, 255

    11111111111111111111111111111111111111111111111111
    10000000000000000000000000010000000000000000000001
    10000000000000010001111111111111111000000000111111
111111000001100000001000000000000000000000000000000001
100000000000000100000010000000010000000000000000011111
10000000000000010000001000001001000000000000000001
10000000000010000000001000000111000000000000001111
10000000000010000000001000000010010000000000000001
1000010000000000000010000N000001001000000000000001
10000000010000000000111111111111100100000000000001
10000000000000000000100000000000010010000000000001
10000000000000000000100000000000001001000000000001
10000100000000000000100000000000000100100000000001
10001110000000000000000000000000000011100000000011
10000100000000011100000000000000000000000000000001
10000000000000000000011111110000000000000000000001
100000000000000100000010000000010000000000000000011
100000000000000100000010000010001000000000000000001
100000000000100000000010000001000100000111111000001
100000000000100000000010000000100010000000000000001
100001000000000000001000000000010001000000000000001
100000000100000000001000000000001000100000000100001
100000000000000100000010000000010000000000000000011
10000000000000010000001000001001000000000000000001
10000000000010000000001000000100100011111100000001
10000000000000010000001000000001000000000000000001
10000000000000010000001000001001000000000000000001
100000000000100000000010000001001000000000000000011
100000000000000000000000000000000000000100000000001
100000000000000000000000000000100000000000000000001
110000000000000000000000000000000001000000000000001
111111111111111111111111111111111111111111111111111
